Last 10 years = 61.35333333333333 
Last 5 years : 66.7
Next 5 years: 71.35333333333334
[ 25  26 300  50  28 200  20  30  40  25  20  20  35 200 200   0  65  54
   0 200 200 200 220  85  30 200 170  55  75  35  50  70  50  65  40  20
  50  30 100  50  60  25  25  25  20  20  30  23  30  33  10  20  40  35
  12  30  30  40  50  12  10  13  12  10  35 110  12 100 150  30 100  35
  37  50  60  50  30  58  56  40  40  60  25  35  40  48  48  30  60  32
  47  40  40  60  80 100 300  55  80  20 200  50  50  30  60  35  80  25
  32  24  10  50  15   6  60  50  20  20   6  60  60  50  40 150 150 140
 130  14 140 110 112 160 150 150 100 120  90 100 120 110 110 120 110  50
 150  20  55  30  70  70]
[ 26  28 323  53  30 215  21  32  43  26  21  21  37 215 215   0  70  58
   0 215 215 215 237  91  32 215 183  59  80  37  53  75  53  70  43  21
  53  32 107  53  64  26  26  26  21  21  32  24  32  35  10  21  43  37
  12  32  32  43  53  12  10  14  12  10  37 118  12 107 161  32 107  37
  39  53  64  53  32  62  60  43  43  64  26  37  43  51  51  32  64  34
  50  43  43  64  86 107 323  59  86  21 215  53  53  32  64  37  86  26
  34  25  10  53  16   6  64  53  21  21   6  64  64  53  43 161 161 151
 140  15 151 118 120 172 161 161 107 129  97 107 129 118 118 129 118  53
 161  21  59  32  75  75]