Last 10 years : 61.35333333333333 
Last 5 years : 66.7
Next 5 years: 71.9
Accuracy of data : 0.8932351884248074
Standard deviation : 0.1736536715369258
[ 25  26 300  50  28 200  20  30  40  25  20  20  35 200 200   0  65  54
   0 200 200 200 220  85  30 200 170  55  75  35  50  70  50  65  40  20
  50  30 100  50  60  25  25  25  20  20  30  23  30  33  10  20  40  35
  12  30  30  40  50  12  10  13  12  10  35 110  12 100 150  30 100  35
  37  50  60  50  30  58  56  40  40  60  25  35  40  48  48  30  60  32
  47  40  40  60  80 100 300  55  80  20 200  50  50  30  60  35  80  25
  32  24  10  50  15   6  60  50  20  20   6  60  60  50  40 150 150 140
 130  14 140 110 112 160 150 150 100 120  90 100 120 110 110 120 110  50
 150  20  55  30  70  70]
[ 28  29 321  53  31 213  26  36  44  27  25  20  40 216 215   0  73  61
   1 215 214 213 235  93  33 217 185  60  82  42  57  78  56  70  43  21
  55  31 106  56  64  27  29  25  23  21  32  25  32  35  11  19  43  39
  14  35  32  44  54  16  15  14  13  11  38 118  22 107 160  32 107  38
  40  54  65  53  33  62  60  46  43  65  29  38  40  52  48  32  64  35
  44  43  43  64  83 104 322  60  85  24 215  53  53  32  65  39  87  28
  33  26  13  52  16   6  65  52  21  21   4  65  65  54  42 161 160 150
 140  14 150 117 119 171 160 160 107 128  96 108 128 118 117 129 117  53
 162  21  60  33  76  76]