Last 10 years : 61.35333333333333 
Last 5 years : 66.7
Next 5 years: 70.72
Accuracy of data : 0.8559924211568948
Standard deviation : 0.16593122359517296
[ 25  26 300  50  28 200  20  30  40  25  20  20  35 200 200   0  65  54
   0 200 200 200 220  85  30 200 170  55  75  35  50  70  50  65  40  20
  50  30 100  50  60  25  25  25  20  20  30  23  30  33  10  20  40  35
  12  30  30  40  50  12  10  13  12  10  35 110  12 100 150  30 100  35
  37  50  60  50  30  58  56  40  40  60  25  35  40  48  48  30  60  32
  47  40  40  60  80 100 300  55  80  20 200  50  50  30  60  35  80  25
  32  24  10  50  15   6  60  50  20  20   6  60  60  50  40 150 150 140
 130  14 140 110 112 160 150 150 100 120  90 100 120 110 110 120 110  50
 150  20  55  30  70  70]
[ 25  27 286  54  29 212  23  34  47  25  21  21  36 215 214   1  67  59
   1 211 213 209 214  93  35 216 198  58  79  36  52  80  50  66  46  21
  50  34 112  52  65  27  27  26  24  21  31  25  33  35  10  22  43  37
  11  33  33  42  51  11  10  12  11  10  36 121  11 131 178  31 111  35
  37  51  62  53  33  60  56  40  40  64  28  35  40  48  48  35  62  32
  48  40  40  62  84 123 281  59  86  22 214  53  54  33  62  36  85  25
  33  26  10  49  20   5  67  54  20  21   6  61  62  53  40 179 182 138
 110  14 130 115 114 171 188 188 106 116  97 118 114 115 113 118 112  51
 172  21  59  34  74  75]